NO textures/wood.xpm
SO textures/wood.xpm
WE textures/wood.xpm
EA textures/wood.xpm

F 164,169,20
C 153,204,255

11111
10001
10001
10001
100S1
11111