NO textures/wood.xpm
SO textures/wood.xpm
WE textures/wood.xpm
EA textures/wood.xpm

F      17,    38,     64




C 218, 234, 235

1111111111111111111111111
10S0110000100000000000001
1000110000000000111111001
1000110000000000110001001
1000000000100000000001001
1111111011111111111111111
      10000000000001     
      10000000000001     
      11111111111111     
