NO textures/test/north.xpm
SO textures/test/south.xpm
WE textures/test/west.xpm
EA textures/test/east.xpm
DOOR textures/test/east.xpm

F 20,20,20
C 200,200,200

111111111111111111111
100000000000000000001
100000000S00000000001
100000000000000000001
1000000000D0000000001
100000000000000000001
100000000100000000001
100000000000000000001
111111111111111111111