NO ./textures/made/made_wall_n.xpm
SO ./textures/flam.xpm
WE ./textures/made/made_wall_w.xpm
EA ./textures/made/made_wall_e.xpm
DOOR ./textures/made/made_door.xpm

F 64,64,64
C 182,182,182

        1111111111111111111111111
        1000000000110000000000001
        1011000001110000000000001
        1001000000D00000000000001
111111111011000001110000000000001
10000000001100000111D11111D111111
11110111111111011100000010001
1111D111111111D11101010010001
11000000110101011100000010001
10000000D00000001100000010001
10000000D00000001101010010001
11000001110101011111011110N0111
11110111 1110101 101111010001
11111111 1111111 111111111111
